0000001111111112222222220000000011111222222
4444440000000111111111222222222233333333333
6666666666666666666666666666666666666666666
1024356124350134243125312121212121212121212
1245562210123012232321212231212222221111111
1111111111111111111100000000000000000111111